καρδιάζω|κρυώνω|||εκαρδιά
αβαίνου|λαβαίνω|||αβήκα
ακισταινούμενε|κουράζομαι|||ακιστάμα
ακιστατέ|κουρασμένος||
ακίχου|αλατίζω|||ακία
αλικογκίζου|εμποδίζω, καθυστερώ|||αλικογκία
ανεμούκ̇ου|πετάω|||ανεμούκα
ανοίντου|ανοίγω|||ανοία
παντέχου|περιμένω|||
αποού|στέλνω|||απολ̣ύκα
άσσου|αλλάζω|||α/εά
βάνου|βάζω|||
δεχάνου|δείχνω|||εδενά
γείρου|επιστρέφω|||εγείρκα
βογού|ευλογώ|||βογήκα
δαίσου|καίω|||εδάκα
καταβαίνου|καταλαβαίνω|||
καραφερίκ̇ου|καταφέρνω|||εκατανέγκα
κατσίνου|δαγκώνω|||εκατσίκα
κ̇ολλίχου|κολλώ|||εκ̇ολλία
μακούκ̇ου|μαλακώνω|||εμακούκα
ντιζικίχου|πειράζω, ενοχλώ|||
ξεκάζου|κοιτάζω|||
ξερίχου|ρίχνω, πετάω|||εξερία
ξεχαίνου|ξεχνάω|||εξεχάκα
πάφου|παύω,σταματάω|||επαύα
πενάκ̇ου|πεθαίνω|||επενάκα
ποτσούνου|φορτώνω|||εποτσούκα
σαλέγγου|κινούμαι|||εσαλεύα
σκαρμούκ̇ου|ξαφνιάζω, τρομάζω|||εσκαρμούκα
σκωρού|συγχωρώ|||εσκουγκία
τσαφήνου|αφήνω,ελευθερώνω|||ετσαφήκα
τσ̌άχου|τρέχω|τσ̌άχου|τσαχίτσου|ετσ̌αχήκα
τσιταίντου|πέφτω|||ετσιτά
τσ̌ίφου|τρίβω|||ετσ̌ίβα
φοζαΐχου|φοβίζω|||εφοζαΐα
φταίου|φταίω|||εφταίκα
φύου|φεύγω|||εφτίκα
χαμεούκ̇ου|χαμηλώνω|||εχαμεούκα
ψαχνίζου|στεγνώνω|||εψαχνία
δουλέγγου|δουλεύω
κ̇ρύζου|πλύνω||κ̇ρύσου|εκ̇ρύα
